1111111111111
1000E00000111
10P0V00000001
1000C00000001
1111111111111