1111111111111
1000000000001
10P0010000001
10100C0000001
1111111111111