1111111111111
1000E00000001
1000010000001
10100C0000001
1111111111111