1111111111111
1111E11111111
11P1111111111
1111C11111111
1111111111111