1111111111111
1000E00000001
10P0010000001
1010000000001
1111111111111