11111111111111111111111111111111111111
1000000000000C000000000000000000000001
1000000C00000000000000000000C000000001
10000P0000000000000000000000C000000001
10000011111110111111111100000000000001
10000000000000110000000000E00000000001
100000111111110000000C0000000000000001
11111111111111111111111111111111111111