1111111111111
1000E00000001
10000P0000001
10000C0000001
1111111111111