1111111111111
1000000000001
1111110100101
1P000C01001E1
1111111111111