11111111111111111111111111111111111111
1000000000001C010000000000000000000001
1000000C10001000000000000000C000000001
1000001000000000000000000000C000000001
1P000011111110111111111100000000000001
10000000000000000000000000000000000001
100000111111110000000C00000000000001E1
11111111111111111111111111111111111111